8
s.......
........
........
..###...
........
.....#..
.....#..
.......e
