16
s...............
................
................
................
................
................
................
##..#.......####
.#..#.......#...
.#..#.......#...
.#..#########...
................
................
................
................
...............e

