8
s.......
###.###.
........
.######.
.#...###
.#.#.#..
...#...#
.#.#.#.e
