16
s.#.....###.....
#.#.##....#..###
#....#.#..#..#..
#.##.###........
..#....#..######
#########...#.#.
......#...#.#...
#.###.#.#.#...##
....#.#.#######.
###.#...#.......
....#######.####
.#####..........
.#...#.######.##
.#.#....#.......
.#.#.####.###.##
...#......#....e

