16
s....######.....
..........#..###
..######..#..#..
..######........
.......#..######
########..######
.......#........
##..#..##...####
.#..#..##...#...
.#..#.......#...
.#..#########...
................
######...####...
.....#..........
..#..##..#######
..#............e

