32
s.##########...##.#######...####
#.#....#.....#.#..........#.....
#.######.#####.#.#.########.####
#.#...#..........#......#.......
#.#.#.#.###############.#######.
#.#.#...#........#...##.#.......
#.#.############.###.##.########
#....#...#.........#.#....#....#
####.#.#.#.###.#####.#.##.#.##.#
.....#.#.#.#.........#..#.#.##.#
####.#.#.#.#.###.######........#
.....#.#...#........#...########
.#####.############.#.###.#.#...
.....#............#...#.....###.
############.##########.###.#...
.............#.#....#.#.#.....#.
#####.######.#.#.##...#.#######.
....#......#.#.#....#......#....
.####.####.#.#.###########.#.###
.......#.#.#...#...........#....
.##.####.#.#####.#.############.
##.....#.#.#...#.###............
#..#.#...#.#.#.....#.###########
#.##.#####.###.###.#.#...#......
#..#........#....#.#.#.#.#.#.#.#
######.#########.#.#...#...#.#.#
...#.#.....#.....#.#.#########.#
.#.#.#.###.###.###.#...........#
.#.#.......#.#.#...#.#########.#
.#...#######.#.#.###.....#...###
.#####.......###.#.#####.#.#....
.......#####...........#...####e

